MODE 1
SIZE 9/11
LIMIT 0/29
COLOR LIMIT 4
STARS 1500/3800/3810
COLLECT COUNT 0/0
COLLECT ITEMS 1/4
10 10 10 10 13 10 10 10 10
10 10 10 10 13 10 10 10 10
10 10 10 10 13 10 10 10 10
00 00 00 00 00 00 00 00 00
10 10 13 10 10 10 13 10 10
10 10 13 10 10 10 13 10 10
10 10 13 10 10 10 13 10 10
00 00 00 00 00 00 00 00 00
10 10 10 10 13 10 10 10 10
10 10 10 10 13 10 10 10 10
10 10 10 10 13 10 10 10 10